##########################################
  A           ##      ##              ##  ##
  ##  ######  ##  ##  ##  ##########  ##  ##
  ##  ##      ##  ##  ##          ##      ##
  ##  ##  ##  ##  ##  ##########  ##########
  ##  ##  ##      ##      ##      ##      ##
  ##  ##  ##########  ##  ##  ######  ##  ##
  ##  ##  ##      ##  ##  ##          ##  ##
  ##  ##  ##  ##  ##  ##  ##############  ##
  ##  ##  ##  ##  ##  ##          ##      ##
  ##  ######  ##  ##############  ##  ######
  ##          ##          ##      ##      ##
  ######################  ##  ##########  ##
  ##  ##          ##      ##              ##
  ##  ##  ######  ##  ##################  ##
  ##  ##  ##      ##  ##              ##  ##
  ##  ##  ##########  ##  ##########  ##  ##
  ##  ##  ##      ##  ##  ##          ##  ##
  ##  ##  ##  ##  ######  ##  ##########  ##
  ##          ##          ##               B
  ##########################################