##########################################
A   ##          ##  ##      ##          ##
##  ##  ######  ##  ##  ##  ######  ##  ##
##      ##      ##      ##  ##      ##  ##
##########  ##  ##########  ##  ######  ##
##          ##              ##      ##  ##
##  ##############  ##############  ##  ##
##              ##                  ##  ##
##########  ##  ##  ##############  ######
##      ##  ##  ##          ##  ##      ##
##  ##  ######  ##########  ##  ######  ##
##  ##          ##          ##      ##  ##
##  ##########  ##  ##############  ##  ##
##      ##      ##  ##      ##      ##  ##
##########  ######  ##  ##  ##  ##  ##  ##
##      ##  ##      ##  ##  ##  ##  ##  ##
##  ##  ##  ##  ######  ##  ##  ##  ##  ##
##  ##      ##      ##  ##  ##  ##  ##  ##
##  ##################  ##  ######  ##  ##
##                      ##          ##   B
##########################################