##################
#A    #   #   #  B#
# ## ## # # ## ## #
# #    #   #    # #
# # ############ # #
# # #        # # # #
# # # # #### # # # #
#   # # #    # #   #
### # # # #### # ###
#     #   #    #   #
####################
